"a" = (/turf/simulated/mineral/floor/ignore_mapgen,/area/mine/unexplored)
"b" = (/obj/tether_away_spawner/underdark_boss,/turf/simulated/mineral/floor/ignore_mapgen,/area/mine/unexplored)
"d" = (/turf/simulated/mineral,/area/mine/unexplored)

(1,1,1) = {"
dddaaaaddd
ddaaaaaadd
daaaaaaaad
aaaaaaaaaa
aaaaaaaaaa
aaaabaaaaa
aaaaaaaaaa
daaaaaaaad
ddaaaaaadd
dddaaaaddd
"}
