//MAP CONVERTED BY dmm2tgm.py THIS HEADER COMMENT PREVENTS RECONVERSION, DO NOT REMOVE
"aa" = (
/turf/simulated/floor/outdoors/mud/xenoprime,
/area/submap/xenoprime/crashed_ship_1)
"ab" = (
/turf/simulated/shuttle/wall/voidcraft/green/xenoprime/nocol,
/area/submap/xenoprime/crashed_ship_1)
"ac" = (
/obj/structure/shuttle/engine/propulsion{
	dir = 1
	},
/turf/simulated/floor/plating/xenoprime,
/area/submap/xenoprime/crashed_ship_1)
"ad" = (
/turf/simulated/floor/tiled/techfloor/xenoprime,
/area/submap/xenoprime/crashed_ship_1)
"ae" = (
/obj/machinery/door/airlock/multi_tile/metal,
/turf/simulated/floor/tiled/techfloor/xenoprime,
/area/submap/xenoprime/crashed_ship_1)
"af" = (
/turf/simulated/floor/plating/xenoprime,
/area/submap/xenoprime/crashed_ship_1)
"ag" = (
/obj/machinery/portable_atmospherics/canister/empty/phoron,
/obj/machinery/atmospherics/portables_connector/fuel,
/turf/simulated/floor/plating/xenoprime,
/area/submap/xenoprime/crashed_ship_1)
"ah" = (
/obj/machinery/portable_atmospherics/canister/phoron,
/obj/machinery/atmospherics/portables_connector/fuel,
/turf/simulated/floor/plating/xenoprime,
/area/submap/xenoprime/crashed_ship_1)
"ai" = (
/obj/effect/decal/cleanable/dirt,
/turf/simulated/floor/tiled/techfloor/xenoprime,
/area/submap/xenoprime/crashed_ship_1)
"aj" = (
/obj/effect/decal/cleanable/blood/xeno,
/turf/simulated/floor/outdoors/mud/xenoprime,
/area/submap/xenoprime/crashed_ship_1)
"ak" = (
/obj/machinery/atmospherics/pipe/manifold/hidden/fuel,
/obj/effect/decal/cleanable/dirt,
/obj/machinery/meter,
/turf/simulated/floor/plating/xenoprime,
/area/submap/xenoprime/crashed_ship_1)
"al" = (
/obj/machinery/atmospherics/pipe/manifold/hidden/fuel,
/obj/effect/decal/cleanable/dirt,
/obj/effect/decal/cleanable/dirt,
/obj/effect/decal/cleanable/dirt,
/obj/machinery/meter,
/turf/simulated/floor/plating/xenoprime,
/area/submap/xenoprime/crashed_ship_1)
"am" = (
/obj/machinery/atmospherics/pipe/simple/hidden/fuel{
	dir = 9
	},
/obj/item/device/radio/off,
/turf/simulated/floor/plating/xenoprime,
/area/submap/xenoprime/crashed_ship_1)
"an" = (
/obj/machinery/atmospherics/pipe/simple/hidden/fuel,
/turf/simulated/shuttle/wall/voidcraft/green/xenoprime/nocol,
/area/submap/xenoprime/crashed_ship_1)
"ao" = (
/obj/machinery/atmospherics/pipe/simple/hidden/fuel,
/obj/effect/decal/cleanable/dirt,
/turf/simulated/floor/plating/xenoprime,
/area/submap/xenoprime/crashed_ship_1)
"ap" = (
/obj/structure/grille{
	density = 0;
	icon_state = "brokengrille"
	},
/obj/item/weapon/beartrap,
/obj/effect/decal/cleanable/dirt,
/turf/simulated/floor/plating/xenoprime,
/area/submap/xenoprime/crashed_ship_1)
"aq" = (
/obj/structure/grille,
/obj/structure/window/reinforced,
/obj/structure/window/reinforced{
	dir = 1
	},
/turf/simulated/floor/plating/xenoprime,
/area/submap/xenoprime/crashed_ship_1)
"ar" = (
/obj/effect/decal/remains/xeno,
/turf/simulated/floor/outdoors/mud/xenoprime,
/area/submap/xenoprime/crashed_ship_1)
"as" = (
/obj/machinery/atmospherics/pipe/simple/hidden/fuel{
	dir = 5
	},
/obj/effect/decal/cleanable/blood/xeno,
/turf/simulated/floor/plating/xenoprime,
/area/submap/xenoprime/crashed_ship_1)
"at" = (
/obj/item/trash/material/metal,
/turf/simulated/floor/outdoors/mud/xenoprime,
/area/submap/xenoprime/crashed_ship_1)
"au" = (
/obj/item/trash/material/metal,
/obj/random/toolbox,
/obj/effect/decal/cleanable/dirt,
/obj/effect/decal/cleanable/dirt,
/turf/simulated/floor/plating/xenoprime,
/area/submap/xenoprime/crashed_ship_1)
"av" = (
/obj/structure/window/reinforced,
/turf/simulated/floor/outdoors/mud/xenoprime,
/area/submap/xenoprime/crashed_ship_1)
"aw" = (
/obj/item/weapon/material/shard{
	icon_state = "medium"
	},
/turf/simulated/floor/outdoors/mud/xenoprime,
/area/submap/xenoprime/crashed_ship_1)
"ax" = (
/obj/machinery/door/airlock/external,
/turf/simulated/floor/plating/xenoprime,
/area/submap/xenoprime/crashed_ship_1)
"ay" = (
/obj/structure/window/reinforced{
	dir = 1
	},
/turf/simulated/floor/outdoors/mud/xenoprime,
/area/submap/xenoprime/crashed_ship_1)
"az" = (
/obj/item/weapon/material/shard,
/turf/simulated/floor/outdoors/mud/xenoprime,
/area/submap/xenoprime/crashed_ship_1)
"aA" = (
/obj/effect/decal/remains/xeno,
/obj/effect/decal/cleanable/blood/xeno,
/turf/simulated/floor/outdoors/mud/xenoprime,
/area/submap/xenoprime/crashed_ship_1)
"aB" = (
/obj/effect/decal/cleanable/blood/xeno,
/turf/simulated/floor/tiled/techfloor/xenoprime,
/area/submap/xenoprime/crashed_ship_1)
"aC" = (
/obj/item/weapon/material/shard{
	icon_state = "medium"
	},
/obj/effect/decal/cleanable/dirt,
/turf/simulated/floor/tiled/techfloor/xenoprime,
/area/submap/xenoprime/crashed_ship_1)
"aD" = (
/obj/structure/grille{
	density = 0;
	icon_state = "brokengrille"
	},
/obj/item/weapon/material/shard{
	icon_state = "medium"
	},
/turf/simulated/floor/plating/xenoprime,
/area/submap/xenoprime/crashed_ship_1)
"aE" = (
/obj/structure/grille{
	density = 0;
	icon_state = "brokengrille"
	},
/obj/effect/decal/cleanable/blood/xeno,
/obj/effect/decal/cleanable/dirt,
/turf/simulated/floor/plating/xenoprime,
/area/submap/xenoprime/crashed_ship_1)
"aF" = (
/obj/machinery/atmospherics/pipe/simple/hidden/fuel,
/obj/structure/table/rack/steel,
/obj/random/tool/power,
/obj/random/tool/power,
/obj/random/tool,
/turf/simulated/floor/plating/xenoprime,
/area/submap/xenoprime/crashed_ship_1)
"aG" = (
/obj/structure/table/rack/steel,
/obj/random/tool/power,
/obj/random/tool/power,
/obj/random/tool,
/obj/random/toolbox,
/turf/simulated/floor/plating/xenoprime,
/area/submap/xenoprime/crashed_ship_1)
"aH" = (
/obj/random/contraband/nofail,
/turf/simulated/floor/tiled/techfloor/xenoprime,
/area/submap/xenoprime/crashed_ship_1)
"aI" = (
/obj/item/weapon/tank/oxygen/red,
/obj/effect/decal/cleanable/dirt,
/turf/simulated/floor/tiled/techfloor/xenoprime,
/area/submap/xenoprime/crashed_ship_1)
"aJ" = (
/obj/machinery/suit_cycler{
	req_access = list()
	},
/turf/simulated/floor/tiled/techfloor/xenoprime,
/area/submap/xenoprime/crashed_ship_1)
"aK" = (
/obj/random/multiple/voidsuit/vintage,
/turf/simulated/floor/tiled/techfloor/xenoprime,
/area/submap/xenoprime/crashed_ship_1)
"aL" = (
/obj/structure/frame,
/obj/effect/decal/cleanable/blood/oil,
/turf/simulated/floor/tiled/techfloor/xenoprime,
/area/submap/xenoprime/crashed_ship_1)
"aM" = (
/obj/structure/frame/computer,
/turf/simulated/floor/tiled/techfloor/xenoprime,
/area/submap/xenoprime/crashed_ship_1)
"aN" = (
/obj/random/outcrop,
/turf/simulated/floor/outdoors/mud/xenoprime,
/area/submap/xenoprime/crashed_ship_1)
"aO" = (
/obj/structure/table/steel,
/obj/random/awayloot/looseloot,
/turf/simulated/floor/tiled/techfloor/xenoprime,
/area/submap/xenoprime/crashed_ship_1)
"aP" = (
/obj/random/powercell,
/obj/structure/table/steel,
/turf/simulated/floor/tiled/techfloor/xenoprime,
/area/submap/xenoprime/crashed_ship_1)
"aQ" = (
/obj/random/crate,
/turf/simulated/floor/outdoors/mud/xenoprime,
/area/submap/xenoprime/crashed_ship_1)
"aR" = (
/obj/machinery/atmospherics/pipe/simple/hidden/fuel,
/obj/random/crate{
	icon_state = "base";
	dir = 4
	},
/turf/simulated/floor/plating/xenoprime,
/area/submap/xenoprime/crashed_ship_1)
"aS" = (
/obj/item/weapon/beartrap{
	anchored = 1;
	deployed = 1;
	icon_state = "beartrap1"
	},
/obj/effect/decal/cleanable/dirt,
/turf/simulated/floor/plating/xenoprime,
/area/submap/xenoprime/crashed_ship_1)
"aT" = (
/obj/item/weapon/book/manual/stasis,
/turf/simulated/floor/tiled/techfloor/xenoprime,
/area/submap/xenoprime/crashed_ship_1)
"aU" = (
/obj/machinery/atmospherics/pipe/simple/hidden/fuel,
/obj/effect/decal/cleanable/dirt,
/obj/structure/loot_pile/surface,
/turf/simulated/floor/plating/xenoprime,
/area/submap/xenoprime/crashed_ship_1)
"aV" = (
/obj/machinery/atmospherics/pipe/simple/hidden/fuel,
/obj/structure/loot_pile/surface/bones,
/turf/simulated/floor/plating/xenoprime,
/area/submap/xenoprime/crashed_ship_1)
"aW" = (
/obj/random/junk,
/turf/simulated/floor/outdoors/mud/xenoprime,
/area/submap/xenoprime/crashed_ship_1)
"aX" = (
/obj/machinery/atmospherics/pipe/manifold/hidden/fuel,
/obj/random/junk,
/turf/simulated/floor/plating/xenoprime,
/area/submap/xenoprime/crashed_ship_1)
"aY" = (
/obj/random/energy,
/turf/simulated/floor/plating/xenoprime,
/area/submap/xenoprime/crashed_ship_1)
"aZ" = (
/obj/effect/decal/cleanable/dirt,
/turf/simulated/floor/plating/xenoprime,
/area/submap/xenoprime/crashed_ship_1)
"ba" = (
/obj/random/junk,
/turf/simulated/floor/tiled/techfloor/xenoprime,
/area/submap/xenoprime/crashed_ship_1)
"bb" = (
/obj/effect/decal/cleanable/blood{
	icon_state = "gibmid3"
	},
/obj/effect/decal/cleanable/dirt,
/turf/simulated/floor/tiled/techfloor/xenoprime,
/area/submap/xenoprime/crashed_ship_1)
"bc" = (
/obj/random/energy/highend,
/obj/effect/decal/cleanable/dirt,
/obj/effect/decal/cleanable/dirt,
/turf/simulated/floor/tiled/techfloor/xenoprime,
/area/submap/xenoprime/crashed_ship_1)
"bd" = (
/obj/effect/decal/cleanable/blood{
	icon_state = "mgibbl5"
	},
/turf/simulated/floor/tiled/techfloor/xenoprime,
/area/submap/xenoprime/crashed_ship_1)
"be" = (
/obj/effect/decal/cleanable/blood,
/turf/simulated/floor/tiled/techfloor/xenoprime,
/area/submap/xenoprime/crashed_ship_1)
"bf" = (
/obj/machinery/atmospherics/pipe/manifold/hidden/fuel,
/obj/item/stack/material/steel{
	amount = 6
	},
/obj/effect/decal/cleanable/dirt,
/obj/effect/decal/cleanable/dirt,
/turf/simulated/floor/plating/xenoprime,
/area/submap/xenoprime/crashed_ship_1)
"bg" = (
/obj/item/stack/material/steel{
	amount = 6
	},
/turf/simulated/floor/tiled/techfloor/xenoprime,
/area/submap/xenoprime/crashed_ship_1)
"bh" = (
/obj/structure/girder,
/turf/simulated/floor/plating/xenoprime,
/area/submap/xenoprime/crashed_ship_1)
"bi" = (
/obj/structure/barricade,
/obj/effect/decal/cleanable/dirt,
/turf/simulated/floor/plating/xenoprime,
/area/submap/xenoprime/crashed_ship_1)
"cO" = (
/obj/structure/frame,
/turf/simulated/floor/plating/xenoprime,
/area/submap/xenoprime/crashed_ship_1)
"dI" = (
/obj/structure/prop/rock/round,
/turf/simulated/floor/outdoors/mud/xenoprime,
/area/submap/xenoprime/crashed_ship_1)
"eV" = (
/obj/item/trash/material/metal,
/obj/effect/decal/cleanable/dirt,
/turf/simulated/floor/outdoors/mud/xenoprime,
/area/submap/xenoprime/crashed_ship_1)
"in" = (
/obj/effect/decal/cleanable/blood/xeno,
/obj/effect/decal/cleanable/dirt,
/turf/simulated/floor/tiled/techfloor/xenoprime,
/area/submap/xenoprime/crashed_ship_1)
"io" = (
/obj/machinery/atmospherics/pipe/manifold/hidden/fuel,
/obj/effect/decal/cleanable/dirt,
/obj/effect/decal/cleanable/blood/oil,
/turf/simulated/floor/plating/xenoprime,
/area/submap/xenoprime/crashed_ship_1)
"oz" = (
/obj/structure/loot_pile/surface,
/turf/simulated/floor/tiled/techfloor/xenoprime,
/area/submap/xenoprime/crashed_ship_1)
"sp" = (
/obj/structure/loot_pile/mecha/ripley,
/turf/simulated/floor/outdoors/mud/xenoprime,
/area/submap/xenoprime/crashed_ship_1)
"Bs" = (
/obj/random/junk,
/obj/effect/decal/cleanable/dirt,
/turf/simulated/floor/tiled/techfloor/xenoprime,
/area/submap/xenoprime/crashed_ship_1)
"FO" = (
/obj/effect/decal/cleanable/dirt,
/turf/simulated/floor/outdoors/mud/xenoprime,
/area/submap/xenoprime/crashed_ship_1)
"Kd" = (
/obj/machinery/atmospherics/pipe/manifold/hidden/fuel,
/obj/effect/decal/cleanable/dirt,
/obj/random/junk,
/turf/simulated/floor/plating/xenoprime,
/area/submap/xenoprime/crashed_ship_1)
"Kf" = (
/obj/effect/decal/cleanable/dirt,
/obj/structure/prop/war/warhead1{
	desc = "This warhead is covered in rust and grime. The armed and unarmed lights are both off."
	},
/turf/simulated/floor/plating/xenoprime,
/area/submap/xenoprime/crashed_ship_1)
"Ld" = (
/obj/structure/prop/rock,
/turf/simulated/floor/outdoors/mud/xenoprime,
/area/submap/xenoprime/crashed_ship_1)
"Ov" = (
/obj/effect/decal/cleanable/dirt,
/obj/effect/decal/cleanable/dirt,
/obj/item/stack/cable_coil/blue{
	amount = 5
	},
/turf/simulated/floor/tiled/techfloor/xenoprime,
/area/submap/xenoprime/crashed_ship_1)
"UM" = (
/obj/random/contraband/nofail,
/obj/effect/decal/cleanable/dirt,
/turf/simulated/floor/tiled/techfloor/xenoprime,
/area/submap/xenoprime/crashed_ship_1)
"Vu" = (
/obj/effect/decal/cleanable/dirt,
/obj/structure/loot_pile/surface/bones,
/turf/simulated/floor/tiled/techfloor/xenoprime,
/area/submap/xenoprime/crashed_ship_1)
"Vx" = (
/obj/structure/prop/rock/sharp,
/turf/simulated/floor/outdoors/mud/xenoprime,
/area/submap/xenoprime/crashed_ship_1)
"VN" = (
/obj/effect/decal/cleanable/dirt,
/obj/item/weapon/tool/prybar/red,
/turf/simulated/floor/tiled/techfloor/xenoprime,
/area/submap/xenoprime/crashed_ship_1)
"WQ" = (
/obj/effect/decal/cleanable/dirt,
/obj/effect/decal/cleanable/dirt,
/turf/simulated/floor/plating/xenoprime,
/area/submap/xenoprime/crashed_ship_1)
"Yq" = (
/obj/machinery/door/airlock/external,
/obj/effect/decal/cleanable/dirt,
/turf/simulated/floor/plating/xenoprime,
/area/submap/xenoprime/crashed_ship_1)

(1,1,1) = {"
dI
aa
aa
aa
aa
aa
aa
aa
aa
aa
aa
aa
aa
aa
aa
aa
aa
aa
aa
aa
aa
aa
aa
"}
(2,1,1) = {"
aa
aa
aa
aa
aa
aj
at
aa
aW
aa
aa
aa
aa
aa
aa
aa
aa
aN
aa
aa
aa
ar
aa
"}
(3,1,1) = {"
aa
aa
aa
aa
aa
aa
aa
aa
aa
at
aa
aa
aa
aa
aa
aa
aa
aa
aa
aa
aa
aa
aa
"}
(4,1,1) = {"
aa
aa
aa
aa
aa
aW
eV
FO
aW
sp
aa
ar
aa
aa
aa
aa
aa
aa
aa
aa
aa
aj
aa
"}
(5,1,1) = {"
aa
aa
aa
ab
ab
ab
aS
bi
aa
aa
aj
aa
aa
aa
aa
ab
ab
ab
ab
ab
aa
aa
aa
"}
(6,1,1) = {"
aa
aa
ab
ab
ag
as
aZ
bh
at
aW
av
Yq
ay
aa
aa
ab
aH
aO
aP
ab
ab
aa
aW
"}
(7,1,1) = {"
aa
aa
ac
an
aF
ak
au
ab
aQ
aa
av
WQ
az
aa
aa
ab
Bs
aB
ai
Bs
aD
aa
aa
"}
(8,1,1) = {"
aa
aa
ac
an
aU
aX
af
ab
ab
ab
ab
ax
ab
ab
ab
ab
Vu
ai
aT
ba
aq
aa
aa
"}
(9,1,1) = {"
aa
aa
ac
an
ao
bf
aY
ae
ad
UM
VN
Bs
bb
oz
ad
ae
ad
Ov
be
aM
aq
aa
aa
"}
(10,1,1) = {"
aa
aa
ac
an
aR
io
aZ
ad
ad
ba
Vu
ai
aI
Bs
UM
ad
bc
ba
aC
aM
aq
aa
az
"}
(11,1,1) = {"
aa
aa
cO
an
aF
Kd
Kf
ab
ab
ab
ab
ax
ab
ab
ab
ab
ai
in
bg
aH
aE
aa
aa
"}
(12,1,1) = {"
Vx
aa
cO
an
aV
al
aZ
ab
aa
aa
aw
aZ
ay
aa
aa
bh
bd
aK
ad
ba
ap
aW
aa
"}
(13,1,1) = {"
aa
aa
ab
ab
ah
am
aG
ab
aa
Ld
av
ax
ay
aa
aa
ab
aJ
ai
aL
ab
ab
aa
az
"}
(14,1,1) = {"
aa
aa
aa
ab
ab
ab
ab
ab
aa
aa
aj
aa
aa
aa
aa
ab
ab
ab
ab
ab
aa
aa
aa
"}
(15,1,1) = {"
aa
aa
aa
aa
aa
aa
aa
aa
aa
aa
aa
aa
aa
aA
aa
aa
aa
aa
aa
aa
aa
aa
aa
"}
(16,1,1) = {"
aa
aa
aa
aa
aj
aa
aa
aa
aa
aa
aa
aa
aa
aa
aa
aa
aa
aa
aa
aa
aa
aa
aa
"}
(17,1,1) = {"
aa
aa
aa
aa
aa
aa
ar
aa
aa
aa
aa
aN
aa
aa
aa
aa
aa
aa
aj
aa
aa
aa
aj
"}
(18,1,1) = {"
aa
aa
aa
aa
aa
aa
aa
aa
aa
aa
aa
aa
aa
aa
aa
aa
aa
aa
aa
aa
aa
aa
aa
"}
