"a" = (/turf/simulated/mineral,/area/mine/unexplored)
"b" = (/turf/simulated/mineral/floor/ignore_mapgen,/area/mine/unexplored)
"c" = (/obj/tether_away_spawner/underdark_hard,/turf/simulated/mineral/floor/ignore_mapgen,/area/mine/unexplored)

(1,1,1) = {"
aaabbbbaaa
aabbbbbbaa
abbbbbbbba
bbbbbbbbbb
bbbbbbbbbb
bbbbbbbbbb
bbbbcbbbbb
abbbbbbbba
aabbbbbbaa
aaabbbbaaa
"}
